
WE ./path_to_the_west_texture
NO ./path_to_the_north_texture

F 220,100,0

SO ./path_to_the_south_texture
EA ./path_to_the_east_texture
C    250 , 5,    10

11111111111111111
10000000000000001
10010000000000001
10010000000000001
1000000N000000001
10010000000000001
10010000000000001
10000000000000001
11111111111111111